assets/level/tileMap.bmp; 8; 8;
0;3;3;4;1;4;
0;3;8;8;2;4;
0;3;3;4;4;4;
0;3;3;4;3;4;
0;3;3;4;7;4;
0;3;4;4;8;4;
0;3;3;4;2;4;
0;3;6;4;1;4;
0;3;3;4;2;4;
0;3;6;5;1;4;